111111
100101
101001
11001
111111