NO ./assets/NO_jorge.xpm
SO ./assets/SO_greywall.xpm
WE ./assets/WE_jorge_carol.xpm
EA ./assets/EA_42.xpm
F 40,114,51
C 0,191,256

        1111111111111111111111111
        1000000000110000000000001
        1011000001110000000011001
        1001000000000000000000001
        1011000001110000001000001
        1001000000000000000000001
111111111011000001110000000000001
100000000011000001110111111111111
11010111111111011100000010001
11010111111111011101010010001
11000000110101011100000010001
10000000000000001100000010001
10E00000000000001101010010001
1000001110101011111011110001111
1000001110101011111011110001111
11110111 1110101 101111010001
11111111 1111111 111111111111