NO ./assets/NO.xpm
SO ./assets/SO.xpm
EA ./assets/EA.xpm
WE ./assets/WE.xpm
F 40,114,255
C 0,191,255


        111111111111111111111111        
111     10000000001100000000000011   1
        1011000001110000000011001   101 
        10010000000000000000000011   1
        10110000011100000010000001  1
        10010000000000000S0000011
11111111101100000111000000000001
100000000011000001110111111111111
11010111111111011100000010001
11010111111111011101010010001
11000000110101011100000010001
10000000000000001100000010001
10000000000000001101010010001
1000001110101011111011110001111
1000001110101011111011110001111
11110111 1110101 101111010001
11111111 1111111 111111111111
