NO ./assets/NO_jorge.xpm
SO ./assets/SO_greywall.xpm
WE ./assets/WE_jorge_carol.xpm
EA ./assets/EA_42.xpm
F 40,114,51
C 0,191,255


1111111111111
1000000000001
100001S000001
1000001000001
1000000000001
1111111111111
