NO ./assets/NO_jorge.xpm
SO ./assets/SO_greywall.xpm
WE ./assets/WE_jorge_carol.xpm
EA ./assets/EA_42.xpm
F 40,114,51
C 0,191,255


11111111
10000W01
11111111